________########_
________#-----@#_
________#-$#$-##_
________#-$--$#__
________##$-$-#__
#########-$-#-###
#....--##-$--$--#
##...----$--$---#
#....--##########
########_________