__####_
__#--#_
__#--#_
__#$-#_
_##-$##
_#--$-#
_#...-#
##$-###
#-.-#__
#--@#__
#####__