______________########
______________#--....#
___############--....#
___#----#--$-$---....#
___#-$$$#$--$-#--....#
___#--$-----$-#--....#
___#-$$-#$-$-$########
####--$-#-----#_______
#---#-#########_______
#----$--##____________
#-$$#$$-@#____________
#---#---##____________
#########_____________